213
3000000000000000000000000000000000000000000000000000000000000000000000000000000000000000000000000000000000000000000000000000000000000000000000000000000000000000000000000000000000000000000000000000000000000000000000
3000000000000000000000000000000000000000000000000000000000000000000000000000000000000000000000000000000000000000000000000000000000000000000000000000000000000000000000000000000000000000000000000000000000000000000000
3000000000000000000000000000000000000000000000000000000000000000000000000000000000000000000000000000000000000000000000000000000000000000000000000000000000000000000000000000000000000000000000000000000000000000000000
3000000000000000000000000000000000000000000000000000000000000000000000000000000000000000000000000000000000000000000000000000000000000000000000000000000000000000000000000000000000000000000000000000000000000000000000
3000000000000000000000000000000000000000000000000000000000000000000000000000000000000000000000000000000000000000000000000000000000000000000000000000000000000000000000000000000000000000000000000000000000000000000000
3000000000000000000000000000000000000000000000022000000000000000000000000112220000000000000000000000000000000000000000000000000000000000000000000000000000000000000000000000000000006000000000000000000000000000000000
3000000000000000002000000000000000000000000600000000000000000000000000000000000000000000000000000000000000000000000000000000000000000000000000000000000000000000000022000000000000066000000000000000000000000000000000
30000000000000000000000000000000000000000200000000000000000000000000006000000100000000000000000000000000000000000000000000000000000000000000000000000000000000000000000T0000000000666T00000000000000000000000000000000
3000000000000000000000000000000000000006000000111100000000000000000060001221100000011120000000000000000000000000000121000012210000000000000000000000000000000000000211110000000006666666660600000000000000000000000000
3000000000000000011100000000000000000000660000000000000000000000006000000000000000000000000000000000000000000000000000000000000000000000000000000000000000000000660000000000000066666000600600000000000000000000000000
3000000000000060000000000000000000000000000060000000000000000006000000000000000000000000000000000000000000000000000000000000000000600600000000006600600000000006666000000000000666666000666600000000000000000009000000
3000000000002011121210000000000000000000000660000000000000000006600661210112000001112212000011000200002002002000010111000001111006600660000000066600660001221100011210000000006666666122100000006000011220000099900000
3000000000000000000000060000000000000000006660000000000000000000006660000000000000000000060000000000000000000000000000002000000066600666000000666600666000000000000000000000066666666000000000066000000000000999990003
3040000005000000000000660000000006G0000006666TT0000000000000000006666000G0000600600005006660000000000000000000000000000000000006666TT6666050066666TT666600000000000000000000666666666000007000666500000000009998999003
3333333333333333333333333333333333333333333333333333333333333773333333333333337733333333333333333333333773333333333333333333333333333333333333333333333333333333333333333333333333333333333333333333333333333333333333
3333333333333333333333333333333333333333333333333333333333333TT333333333333333TT33333333333333333333333TT3333333333333333333333333333333333333333333333333333333333333333333333333333333333333333333333333333333333333