213
3000000000000000000000000000000000000000000000000000000000000000000000000000000000000000000000000000000000000000000000000000000000000000000000000000000000000000000000000000000000000000000000000000000000000000000003
3000000000000000000000000000000000000000000000000000000000000000000000000000000000000000000000000000000000000000000000000000000000000000000000000000000000000000000000000000000000000002020000000000000000000000000003
3000000000000000000000000000000000000000000000000000000000000000000000000000000000000000000000000000000000000000000000000000000000000000000000000000000000000000000000000000000000000000000000000000000000000000000003
3000000000000000000000000000000000000000000000000000000000000000000000000000000000000000000000000000000000000000000000000000000000000000000000000000000000000000000000000000000000000000000000000000000000000000000003
3000000000000000000000000000000000000000000000000000000000000000000000000000000000000000000000000000000000000000000000000000000000000000000000000000000000000000000000000000000000000111111000000000002222200000000003
3000000000000000000000000000000000000000000000000000000000000000000000000000000000000000000000000000000000000000000000000000000022200000000000000000000000000000000000000000000000006000000000000000000000000000000003
3000000000000000002000000000000000000000000000022221100000000000000000000000000000000000000000000000000000000000000000000000000000000000000000000000000000000000000000000000000000066000000000121212000000000000000003
3000000000000000000000000000000000000000000000000001122000000000000021221100000000000000000000000000000000000000000000000000000011160000000012000000000000000000000000000000000000666000000000000000001111100000000003
3000000000000000000000000000000000000000000000000000000000000000000000000011100100011121121111121111100000000000000202000012210000000060060000000000000000000000000000000000000006666000000000000000011000000000000003
3000000000000000000000000000000000000000000000011110000000006006000000000000000000000000000000000000000000000000000000000000000000000000666000000000000000000000000000000000000066666000111111111111111000000000000003
3000000000000200000000000000000000000000000000000000666600066006000066111100000000000065000000000000006011006111100101000011110000600600600066006600600000000000000000000000000666666000000000000000000000000009000003
3000060000200000201111000000112210000001212121200000000000666006000001210060000000000011111111111111111000066000020000000002200006600660006600066600660000000000011210000000006666666000000000000000000000000099900003
3000660000000000000000060000000000000000000000000000000006666006000000000006000000000000000000000000000000666000000000000000000066600666666660666600666000000000000000000000066666666000000000000000000000000999990003
340666006500006000G000660000000G000000G000000000000500006666600650000000000056000000000000000000000000000666600G0006000006050006666TT6666666666666006666000000G0005000005000666666666TTTTTTTTTTTTTTTTT0000009998999003
3333330033333333333333333333333333333333333333333333333333333773333333333333337333333333333333333333333333333333333373373333333333333333333333333333333333333333333333333333333333333333333333333333333333333333333333
3333337733333333333333333333333333333333333333333333333333333TT333333333333333T3333333333333333333333333333333333333T33T3333333333333333333333333333333333333333333333333333333333333333333333333333333333333333333333