213
3000000000000000000000000000000000000000000000000000000000000000000000000000000000000000000000000000000000000000000000000000000000000000000000000000000000000000000000000000000000000000000000000000000000000000000000
3000000000000000000000000000000000000000000000000000000000000000000000000000000000000000000000000000000000000000000000000000000000000000000000000000000000000000000000000000000000000000000000000000000000000000000000
3000000000000000000000000000000000000000000000000000000000000000000000000000000000000000000000000000000000000000000000000000000000000000000000000000000000000000000000000000000000000000000000000000000000000000000000
3000000000000000000000000000000000000000000000000000000000000000000000000000000000000000000000000000000000000000000000000000000000000000000000000000000000000000000000000000000000000000000000000000000000000000000000
3000000000000000000000000000000000000000000000000000000000000000000000000000000000000000000000000000000000000000000000000000000000000000000000000000000000000000000000000000000000000000000000000000000000000000000000
3000000000000000000000000000000000000000000000000000000000000000000000000000000000000000000000000000000000000000000000000000000000000000000000000000000000000000000000000000000000000000000000000000000000000000000000
3000000000000000002000000000000000000000000000022000000000000000000000000000000000000000000000000000000000000000000000000000000000000000000000000000000000000000000000000000000000066000000000000000000000000000000000
3000000000000000000000000000000000000000000000000000000000000000000000000000000000000000000000000000000000000000000000000000000000000000000000000000000000000000000000000000000000666000000000000000000000000000000000
3000000000000000000000000000000000000000000000011100000000000000000000001221100000011120000000000000000000000000000121000012210000000000000000000000000000000000000000000000000006666000000000000000000000000000000000
3000000000000000011100000000000000000000000000000000000000000000000000000000000000000000000000000000000000000000000000000000000000000000000000000000000000000000000000000000000066666000000000000000000000000000000000
3000000000000060000000000000000000000000000060000000000000000000000000000000000000000000000000000000000000000000000000000000000000600600000000006600600000000000000000000000000666666000000000000000000000000009000000
3000000000002000000000000000000000000000000660000000000000000000000061210112000001110010000011000200002002002000010111000001111006600660000000066600660001111100011210000000006666666000000000000000000000000099900000
3000000000000000000000060000000000000000006660000000000000000000006660000000000000000000000000000000000000000000000000000000000066600666000000666600666000000000000000000000066666666000000000000000000000000999990003
304000060500000000006766000000000600000006666TT000000000000000000666600000000600000000000000000000000000000000000000000000000006666TT6666000066666TT666600000000000000000000666666666000003000000000000000009998999003
3333333333333333333333333333333333333333333333333333333333333003333333333333330033333333333333333333333333333333333333333333333333333333333333333333333333333333333333333333333333333333333333333333333333333333333333
3333333333333333333333333333333333333333333333333333333333333TT333333333333333TT33333333333333333333333333333333333333333333333333333333333333333333333333333333333333333333333333333333333333333333333333333333333333